customerid,nrofautomatedtestcases,nrofmanualtestcases,nrofmanualtestcasesexecutedperyear,nrofautomatedtestcasesexecutedperyear,nroftotaltestcasesexecutedperyear,costavoidanceperyear,hoursspentontestingperyear,hoursspentonmanualtestingperyear,hoursspentonautomatedtestingperyear,hoursspentonautomatedtestprep,hoursspentonautomatedtestexec,hoursspentonmanualtestprep,hoursspentonmanualtestexec,Totallaborcostperyear
0,200,800,41360,10340,51700,2304000,21846,20808,1038,862,172,13787,6893,980000
1,0,9368,32666,0,32666,2275000,19454,19454,0,0,0,8167,10889,1400000
2,0,9368,32666,0,32666,2275000,19454,19454,0,0,0,8167,10889,1400000
3,0,9368,32666,0,32666,2275000,19454,19454,0,0,0,8167,10889,1400000
4,0,9368,32666,0,32666,2275000,19454,19454,0,0,0,8167,10889,1400000
11,0,9368,2201527,0,2201527,2275000,1284622,1284622,0,0,0,550382,733842,1400000
12,0,9368,2201527,0,2201527,2275000,1284622,1284622,0,0,0,550382,733842,1400000
13,0,9368,2201527,0,2201527,2275000,1284622,1284622,0,0,0,550382,733842,1400000
15,0,101739,17804,0,17804,138840,89969,89969,0,0,0,60062,29673,3000000
15,0,101739,17804,0,17804,138840,89969,89969,0,0,0,60062,29673,3000000
16,0,101739,19249,0,19249,138840,97021,97021,0,0,0,64937,32082,3000000
19,0,1368,13680,0,13680,150000,5705,5705,0,0,0,2280,3420,650000
23,200,800,34000,8500,42500,2304000,17978,17128,850,708,142,11333,5667,660909
24,200,800,34000,8500,42500,0,17978,17128,850,708,142,11333,5667,660909
25,200,800,34000,8500,42500,0,17978,17128,850,708,142,11333,5667,660909
5,0,1360,2047,0,2047,150000,23754,23754,0,0,0,20507,2047,650000
6,0,1360,2047,0,2047,150000,23754,23754,0,0,0,20507,2047,650000
7,0,1350,4091,0,4091,196677000,17758,17758,0,0,0,8864,8864,1230000
8,0,1350,4091,0,4091,196677000,17758,17758,0,0,0,8864,8864,1230000
9,0,3000,20550,0,20550,0,13705,13705,0,0,0,10275,3425,500000
10,0,3000,20550,0,20550,0,13705,13705,0,0,0,10275,3425,500000
14,200,800,41360,10340,51700,2304000,21846,20808,1038,862,172,13787,6893,980000
17,200,800,41360,10340,51700,0,21846,20808,1038,862,172,13787,6893,0
18,85,1609,35141,1856,36997,0,78480,48660,29820,29696,124,35141,13471,220000
20,0,1368,13680,0,13680,150000,5705,5705,0,0,0,2280,3420,650000
21,0,1609,35141,0,35141,2001000,48660,48660,0,0,0,35141,13471,220000
22,0,1609,35141,0,35141,2001000,48660,48660,0,0,0,35141,13471,220000
33,200,800,34000,8500,42500,2304000,17978,17128,850,708,142,11333,5667,660909
34,200,800,34000,8500,42500,0,17978,17128,850,708,142,11333,5667,660909
35,200,800,34000,8500,42500,2304000,17978,17128,850,708,142,11333,5667,660909
26,200,800,34000,8500,42500,0,17978,17128,850,708,142,11333,5667,660909
27,200,800,34000,8500,42500,0,17978,17128,850,708,142,11333,5667,660909
31,0,101739,19249,0,19249,254704,97021,97021,0,0,0,64937,32082,3000000
32,0,101739,19249,0,19249,254702,97021,97021,0,0,0,64937,32082,3000000
41,0,1609,35141,0,35141,2001000,48660,48660,0,0,0,35141,13471,1470812
58,15,280,3469,186,3655,2001000,7829,4847,2982,2976,6,3469,1330,2278272
85,0,450,17955,0,17955,250000,6013,6013,0,0,0,2993,2993,200000
89,0,450,17955,0,17955,250000,6013,6013,0,0,0,2993,2993,200000
95,23,427,2285,124,2409,150000,794,768,26,10,10,381,381,20000
96,23,427,2285,124,2409,150000,794,768,26,10,10,381,381,20000
110,0,1000,4250,0,4250,0,0,0,0,0,0,2125,708,0
114,0,1000,4250,0,4250,0,2834,2834,0,0,0,2125,708,500000
115,0,1000,4250,0,4250,0,2834,2834,0,0,0,2125,708,500000
124,0,10000,17000,0,17000,138840,5668,5668,0,0,0,2833,2833,3000000
178,0,9368,27823,0,27823,2275000,16628,16628,0,0,0,6956,9274,1400000
28,200,800,34000,8500,42500,0,17978,17128,850,708,142,11333,5667,660909
29,200,800,34000,8500,42500,0,17978,17128,850,708,142,11333,5667,660909
36,200,800,34000,8500,42500,0,17978,17128,850,708,142,11333,5667,660909
43,20000,80000,3400000,850000,4250000,24000000,1785128,1700128,85000,70833,14167,1133333,566667,10000000
44,0,9368,2201527,0,2201527,2275000,1284622,1284622,0,0,0,550382,733842,1400000
45,20000,80000,3400000,850000,4250000,24000000,1785128,1700128,85000,70833,14167,1133333,566667,10000000
46,20000,80000,3400000,850000,4250000,5000000,1785128,1700128,85000,70833,14167,1133333,566667,10000000
47,20000,80000,3400000,850000,4250000,5000000,1785128,1700128,85000,70833,14167,1133333,566667,10000000
48,1960,7840,333200,83300,416500,5000000,175058,166728,8330,6942,1388,111067,55533,1400000
49,1960,7840,333200,83300,416500,500000,175058,166728,8330,6942,1388,111067,55533,1400000
50,170,3227,3536,186,3722,0,7921,4939,2982,2976,6,3536,1355,2278272
51,170,3227,3536,186,3722,2001000,7921,4939,2982,2976,6,3536,1355,2278272
52,0,3397,3722,0,3722,2001000,5197,5197,0,0,0,3722,1427,2278272
53,0,3397,3722,0,3722,2001000,5197,5197,0,0,0,3722,1427,2090112
54,0,1705,2026,0,2026,2001000,2827,2827,0,0,0,2026,777,2090112
37,200,800,34000,8500,42500,0,17978,17128,850,708,142,11333,5667,660909
55,85,1620,1925,101,2026,2001000,4306,2687,1619,1616,3,1925,738,2278272
56,0,3397,3722,0,3722,2001000,5197,5197,0,0,0,3722,1427,2090112
57,170,3227,3536,186,3722,2001000,7921,4939,2982,2976,6,3536,1355,2278272
59,0,1705,2026,0,2026,2001000,2827,2827,0,0,0,2026,777,0
64,0,450,17955,0,17955,250000,6013,6013,0,0,0,2993,2993,200000
66,0,450,17955,0,17955,250000,6013,6013,0,0,0,2993,2993,200000
67,0,450,17955,0,17955,250000,6013,6013,0,0,0,2993,2993,200000
68,0,450,17955,0,17955,250000,6013,6013,0,0,0,2993,2993,200000
69,0,1705,3713,0,3713,2001000,5184,5184,0,0,0,3713,1423,2090112
70,0,1705,3713,0,3713,2001000,5184,5184,0,0,0,3713,1423,2090112
74,0,450,17955,0,17955,250000,6013,6013,0,0,0,2993,2993,200000
75,0,450,17955,0,17955,250000,6013,6013,0,0,0,2993,2993,200000
76,0,450,17955,0,17955,250000,6013,6013,0,0,0,2993,2993,200000
77,0,450,17955,0,17955,250000,6013,6013,0,0,0,2993,2993,200000
38,85,1609,35141,1856,36997,2001000,78418,48660,29758,29696,62,35141,13471,2278272
39,0,1609,35141,0,35141,2001000,48660,48660,0,0,0,35141,13471,0
40,0,1609,35141,0,35141,2001000,48660,48660,0,0,0,35141,13471,0
42,0,1609,35141,0,35141,0,48660,48660,0,0,0,35141,13471,2278272
60,0,1705,2026,0,2026,2001000,2827,2827,0,0,0,2026,777,0
61,85,1620,1925,101,2026,2001000,4306,2687,1619,1616,3,1925,738,2278272
62,0,3397,3722,0,3722,2001000,5197,5197,0,0,0,3722,1427,2090112
63,170,3227,3536,186,3722,2001000,7921,4939,2982,2976,6,3536,1355,2278272
65,0,450,17955,0,17955,250000,6013,6013,0,0,0,2993,2993,200000
71,0,295,3655,0,3655,2001000,5104,5104,0,0,0,3655,1401,2090112
73,0,450,17955,0,17955,250000,6013,6013,0,0,0,2993,2993,200000
78,0,450,17955,0,17955,250000,6013,6013,0,0,0,2993,2993,200000
79,0,450,17955,0,17955,250000,6013,6013,0,0,0,2993,2993,200000
80,0,450,17955,0,17955,250000,6013,6013,0,0,0,2993,2993,200000
81,0,450,17955,0,17955,250000,6013,6013,0,0,0,2993,2993,200000
82,0,450,17955,0,17955,250000,6013,6013,0,0,0,2993,2993,200000
83,0,450,17955,0,17955,250000,6013,6013,0,0,0,2993,2993,200000
84,0,450,17955,0,17955,250000,6013,6013,0,0,0,2993,2993,200000
88,0,450,17955,0,17955,250000,6013,6013,0,0,0,2993,2993,200000
90,0,450,17955,0,17955,250000,6013,6013,0,0,0,2993,2993,200000
91,0,450,17955,0,17955,250000,6013,6013,0,0,0,2993,2993,200000
97,23,427,3502,189,3691,150000,1206,1171,35,16,16,584,584,280000
98,23,427,3502,189,3691,150000,1206,1171,35,16,16,584,584,280000
99,0,3397,3722,0,3722,2001000,5197,5197,0,0,0,3722,1427,2090112
100,900,8100,238950,26550,265500,150000,88512,79656,8856,4425,4425,39825,39825,180000
101,1800,7200,38520,9630,48150,100000,14452,12843,1609,803,803,6420,6420,1790000
102,0,1000,3800,0,3800,150000,0,0,0,0,0,1267,1267,0
103,0,1000,3800,0,3800,150000,2537,2537,0,0,0,1267,1267,200000
104,0,1000,0,0,0,0,0,0,0,0,0,0,0,200000
106,0,1000,4250,0,4250,0,2834,2834,0,0,0,2125,708,500000
86,0,450,17955,0,17955,250000,6013,6013,0,0,0,2993,2993,200000
87,0,450,17955,0,17955,250000,6013,6013,0,0,0,2993,2993,200000
92,0,450,17955,0,17955,250000,6013,6013,0,0,0,2993,2993,200000
93,279,157,3956,7031,10987,0,40032,3159,36873,35155,1406,1319,1648,2382849
94,279,157,3956,7031,10987,0,40032,3159,36873,35155,1406,1319,1648,2382849
105,0,1000,4250,0,4250,0,2834,2834,0,0,0,2125,708,500000
107,0,1000,4250,0,4250,0,2834,2834,0,0,0,2125,708,500000
108,0,1000,4250,0,4250,0,0,0,0,0,0,2125,708,0
109,0,1000,4250,0,4250,0,0,0,0,0,0,2125,708,0
112,0,1000,4250,0,4250,0,2834,2834,0,0,0,2125,708,500000
118,0,9000,34200,0,34200,0,45603,45603,0,0,0,28500,17100,500000
119,0,2000,14500,0,14500,0,14505,14505,0,0,0,7250,7250,290000
120,0,2000,14500,0,14500,0,14505,14505,0,0,0,7250,7250,290000
125,0,10000,17000,0,17000,138840,5668,5668,0,0,0,2833,2833,3000000
126,0,0,0,0,0,750000,0,0,0,0,0,0,0,800000
111,0,1000,4250,0,4250,0,2834,2834,0,0,0,2125,708,500000
127,0,10000,17000,0,17000,138840,5668,5668,0,0,0,2833,2833,3000000
128,0,0,0,0,0,750000,0,0,0,0,0,0,0,800000
129,200,800,34000,8500,42500,2304000,17978,17128,850,708,142,11333,5667,937409
130,0,1000,42500,0,42500,2304000,21378,21378,0,0,0,14167,7083,800000
131,0,0,0,0,0,50000,0,0,0,0,0,0,0,800000
133,200,800,41360,10340,51700,2304000,21846,20808,1038,862,172,13787,6893,980000
134,200,800,16400,4100,20500,2304000,8662,8248,414,342,68,5467,2733,980000
135,200,800,16400,4100,20500,2304000,8662,8248,414,342,68,5467,2733,980000
136,200,800,34000,8500,42500,2304000,17982,17128,854,708,142,11333,5667,980000
137,0,3000,20550,0,20550,0,13705,13705,0,0,0,10275,3425,500000
149,0,8000,292000,0,292000,9000000,365009,365009,0,0,0,292000,73000,1050000
150,0,8000,292000,0,292000,9000000,365009,365009,0,0,0,292000,73000,1050000
151,0,8000,292000,0,292000,9000000,365009,365009,0,0,0,292000,73000,1050000
157,0,450,17955,0,17955,250000,6013,6013,0,0,0,2993,2993,200000
113,0,1000,4250,0,4250,0,2834,2834,0,0,0,2125,708,500000
116,100,900,3420,380,3800,160000,1270,1142,128,63,63,570,570,580000
117,0,1000,4250,0,4250,0,2834,2834,0,0,0,2125,708,500000
121,0,101739,19249,0,19249,138840,97021,97021,0,0,0,64937,32082,3000000
122,0,101739,19249,0,19249,254702,97021,97021,0,0,0,64937,32082,3000000
123,0,101739,172956,0,172956,138840,57654,57654,0,0,0,28826,28826,3000000
132,0,5000,47500,0,47500,150000,15964,15964,0,0,0,7917,7917,800000
138,0,29705,2281344,0,2281344,0,5715600,5715600,0,0,0,1140672,4562688,10269346
139,0,29705,2281344,0,2281344,0,5715600,5715600,0,0,0,1140672,4562688,10269346
140,0,8347,133552,0,133552,0,111354,111354,0,0,0,55647,55647,1380000
141,0,8347,133552,0,133552,0,111354,111354,0,0,0,55647,55647,1380000
142,0,2250,11367000,0,11367000,0,68202060,68202060,0,0,0,11367000,56835000,561500
143,0,2250,117000,0,117000,0,702040,702040,0,0,0,117000,585000,561500
144,0,2250,117000,0,117000,0,702040,702040,0,0,0,117000,585000,561500
145,0,3000,32400,0,32400,0,32520,32520,0,0,0,16200,16200,800000
146,0,3000,32400,0,32400,0,32520,32520,0,0,0,16200,16200,800000
147,0,4000,56320,0,56320,0,47053,47053,0,0,0,18773,28160,927000
148,0,4000,56320,0,56320,0,47053,47053,0,0,0,18773,28160,927000
152,0,10000,17000,0,17000,138840,5668,5668,0,0,0,2833,2833,3000000
153,0,10000,17000,0,17000,138840,5668,5668,0,0,0,2833,2833,3000000
154,0,10000,17000,0,17000,138840,5668,5668,0,0,0,2833,2833,3000000
155,0,8000,292000,0,292000,9000000,365009,365009,0,0,0,292000,73000,1050000
156,0,8000,292000,0,292000,9000000,365009,365009,0,0,0,292000,73000,1050000
163,0,1000,40000,0,40000,0,41000,41000,0,0,0,20000,20000,1729500
164,0,1000,40000,0,40000,0,41000,41000,0,0,0,20000,20000,1729500
165,0,900,95400,0,95400,0,262880,262880,0,0,0,127200,127200,1260000
166,0,900,95400,0,95400,0,262880,262880,0,0,0,127200,127200,1260000
167,0,900,95400,0,95400,0,262880,262880,0,0,0,127200,127200,1260000
177,0,9368,1171,0,1171,5600000,788,788,0,0,0,293,390,331458
181,0,10000,17000,0,17000,138840,5668,5668,0,0,0,2833,2833,3000000
158,0,9368,2201527,0,2201527,2275000,1284622,1284622,0,0,0,550382,733842,1400000
159,0,9368,2201527,0,2201527,2275000,1284622,1284622,0,0,0,550382,733842,1400000
160,0,9368,2201527,0,2201527,2275000,1284622,1284622,0,0,0,550382,733842,1400000
161,0,9368,32666,0,32666,2275000,19454,19454,0,0,0,8167,10889,1400000
162,0,9368,32666,0,32666,2275000,19454,19454,0,0,0,8167,10889,1400000
168,0,9368,585547,0,585547,5600000,341674,341674,0,0,0,146387,195182,331458
169,0,9368,585547,0,585547,5600000,341674,341674,0,0,0,146387,195182,331458
170,0,9368,5855,0,5855,5600000,3521,3521,0,0,0,1464,1952,331458
171,0,9368,27823,0,27823,2275000,16628,16628,0,0,0,6956,9274,1400000
172,0,9368,1171,0,1171,5600000,788,788,0,0,0,293,390,331458
173,0,9368,32666,0,32666,2275000,19454,19454,0,0,0,8167,10889,1400000
174,0,9368,32666,0,32666,2275000,19454,19454,0,0,0,8167,10889,1400000
175,0,9368,32666,0,32666,2275000,19454,19454,0,0,0,8167,10889,1400000
176,0,9368,32666,0,32666,2275000,19454,19454,0,0,0,8167,10889,1400000
179,0,9368,27823,0,27823,2275000,16628,16628,0,0,0,6956,9274,1400000
180,0,9368,27823,0,27823,2275000,16628,16628,0,0,0,6956,9274,1400000
182,0,10000,4250,0,4250,138840,1417,1417,0,0,0,708,708,3000000
183,0,9368,27870,0,27870,2275000,16458,16458,0,0,0,6968,9290,1400000
184,0,9368,27870,0,27870,2275000,16263,16263,0,0,0,6968,9290,1400000
197,0,9368,8578,0,8578,2275000,5109,5109,0,0,0,2145,2859,1537409
203,0,9368,4803,0,4803,5600000,2862,2862,0,0,0,1201,1601,391191
204,0,9368,4803,0,4803,5600000,2862,2862,0,0,0,1201,1601,391191
207,0,1350,4091,0,4091,196677000,17758,17758,0,0,0,8864,8864,1230000
208,0,1350,4091,0,4091,0,17758,17758,0,0,0,8864,8864,1230000
209,0,1350,4091,0,4091,0,17758,17758,0,0,0,8864,8864,1230000
210,1800,7200,306000,76500,382500,2304000,160778,153128,7650,6375,1275,102000,51000,937409
211,1800,7200,306000,76500,382500,2304000,160778,153128,7650,6375,1275,102000,51000,937409
215,0,9368,137897,0,137897,2275000,80698,80698,0,0,0,34474,45966,1400000
216,0,9368,137897,0,137897,2275000,80698,80698,0,0,0,34474,45966,1400000
217,0,9368,137897,0,137897,2275000,80698,80698,0,0,0,34474,45966,1400000
185,0,9368,27870,0,27870,2275000,16258,16258,0,0,0,6968,9290,1400000
186,0,9368,32320,0,32320,2275000,18853,18853,0,0,0,8080,10773,1400000
187,0,9368,8900,0,8900,2275000,5192,5192,0,0,0,2225,2967,1400000
188,0,9368,27870,0,27870,2275000,16258,16258,0,0,0,6968,9290,1400000
189,0,10000,29250,0,29250,138840,9751,9751,0,0,0,4875,4875,3000000
190,0,10000,29250,0,29250,138840,9752,9752,0,0,0,4875,4875,3000000
191,0,9368,36893,0,36893,2275000,21919,21919,0,0,0,9223,12298,1400000
192,0,9368,36893,0,36893,2275000,21919,21919,0,0,0,9223,12298,1400000
193,0,9368,36893,0,36893,2275000,21919,21919,0,0,0,9223,12298,1400000
194,0,9368,36893,0,36893,2275000,21919,21919,0,0,0,9223,12298,1400000
195,0,9368,36893,0,36893,2275000,21919,21919,0,0,0,9223,12298,1400000
196,0,9368,9438,0,9438,2275000,5611,5611,0,0,0,2360,3146,1537409
198,0,9368,6236,0,6236,2275000,3698,3698,0,0,0,1559,2079,1537409
199,0,9368,4803,0,4803,2275000,2862,2862,0,0,0,1201,1601,1400000
200,0,9368,4803,0,4803,2275000,2862,2862,0,0,0,1201,1601,391191
201,0,9368,4803,0,4803,5600000,2862,2862,0,0,0,1201,1601,391191
212,0,9368,129091,0,129091,2275000,75531,75531,0,0,0,32273,43030,1400000
213,0,9368,137897,0,137897,2275000,80698,80698,0,0,0,34474,45966,1400000
214,0,9368,137897,0,137897,2275000,80698,80698,0,0,0,34474,45966,1400000
219,0,9368,137897,0,137897,2275000,80698,80698,0,0,0,34474,45966,1400000
221,0,500,13138,0,13138,13275000,7706,7706,0,0,0,4379,3285,1864434
222,0,500,13138,0,13138,13275000,7664,7664,0,0,0,4379,3285,1864434
223,0,500,3941,0,3941,13275000,2299,2299,0,0,0,1314,985,1864434
224,0,500,3941,0,3941,13275000,2299,2299,0,0,0,1314,985,1864434
225,0,500,13138,0,13138,13275000,7664,7664,0,0,0,4379,3285,1864434
226,0,500,13138,0,13138,13275000,7664,7664,0,0,0,4379,3285,1864434
227,0,500,13138,0,13138,13275000,7694,7694,0,0,0,4379,3285,1864434
229,0,500,13138,0,13138,13275000,7694,7694,0,0,0,4379,3285,1864434
231,0,500,13138,0,13138,13275000,7694,7694,0,0,0,4379,3285,1864434
244,0,9368,32666,0,32666,2275000,19454,19454,0,0,0,8167,10889,1464434
202,0,9368,4803,0,4803,5600000,2862,2862,0,0,0,1201,1601,391191
228,0,500,13138,0,13138,13275000,7694,7694,0,0,0,4379,3285,1864434
233,0,500,13138,0,13138,13275000,7694,7694,0,0,0,4379,3285,1864434
236,0,500,13138,0,13138,13275000,7742,7742,0,0,0,4379,3285,1864434
245,0,9368,32666,0,32666,2275000,19454,19454,0,0,0,8167,10889,1464434
246,0,9368,32666,0,32666,2275000,19454,19454,0,0,0,8167,10889,1464434
247,0,9368,32666,0,32666,2275000,19454,19454,0,0,0,8167,10889,1464434
257,0,9368,32666,0,32666,2275000,19454,19454,0,0,0,8167,10889,1464434
258,0,9368,32666,0,32666,2275000,19454,19454,0,0,0,8167,10889,1464434
259,0,9368,32666,0,32666,2275000,19454,19454,0,0,0,8167,10889,1464434
260,0,9368,32666,0,32666,0,19171,19171,0,0,0,8167,10889,1464434
261,0,2500,85000,0,85000,0,610943,610943,0,0,0,170000,440583,420000
263,0,500,13350,0,13350,1327500,7880,7880,0,0,0,3338,4450,1864434
264,0,500,13350,0,13350,1327500,7880,7880,0,0,0,3338,4450,1864434
268,0,9368,36893,0,36893,2275000,21919,21919,0,0,0,9223,12298,1400000
205,0,1350,4091,0,4091,196677000,17758,17758,0,0,0,8864,8864,1230000
206,0,1350,4091,0,4091,196677000,17758,17758,0,0,0,8864,8864,1230000
232,0,500,13138,0,13138,13275000,7694,7694,0,0,0,4379,3285,1864434
269,0,9368,36893,0,36893,2275000,21919,21919,0,0,0,9223,12298,1400000
270,0,9368,36893,0,36893,2275000,21919,21919,0,0,0,9223,12298,1400000
271,0,9368,36893,0,36893,2275000,21919,21919,0,0,0,9223,12298,1400000
272,0,9368,36893,0,36893,2275000,21919,21919,0,0,0,9223,12298,1400000
273,0,9368,36893,0,36893,2275000,21919,21919,0,0,0,9223,12298,1400000
274,0,9368,36893,0,36893,2275000,21919,21919,0,0,0,9223,12298,1400000
275,0,9368,36893,0,36893,2275000,21919,21919,0,0,0,9223,12298,1400000
279,0,7668,30198,0,30198,2275000,18014,18014,0,0,0,7550,10066,1400000
281,0,23,184,0,184,0,632,632,0,0,0,184,368,55200
282,0,23,184,0,184,0,632,632,0,0,0,184,368,55200
283,0,23,184,0,184,0,632,632,0,0,0,184,368,0
284,0,23,184,0,184,0,632,632,0,0,0,184,368,55200
218,0,9368,137897,0,137897,2275000,80698,80698,0,0,0,34474,45966,1400000
237,0,9368,32666,0,32666,2275000,19454,19454,0,0,0,8167,10889,1464434
238,0,9368,32666,0,32666,2275000,19454,19454,0,0,0,8167,10889,1464434
239,0,9368,32666,0,32666,2275000,19454,19454,0,0,0,8167,10889,1464434
285,0,23,184,0,184,0,632,632,0,0,0,184,368,55200
286,0,23,184,0,184,0,632,632,0,0,0,184,368,55200
290,0,500,13350,0,13350,1327500,7880,7880,0,0,0,3338,4450,1864434
291,0,500,13350,0,13350,1327500,7880,7880,0,0,0,4450,3338,1864434
292,0,500,13350,0,13350,1327500,7880,7880,0,0,0,4450,3338,1864434
293,0,2500,85000,0,85000,0,610673,610673,0,0,0,170000,440583,420000
294,0,1000,46000,0,46000,0,19267,19267,0,0,0,7667,11500,420000
295,0,2500,85000,0,85000,0,610673,610673,0,0,0,170000,440583,420000
296,0,1000,46000,0,46000,0,19267,19267,0,0,0,7667,11500,420000
297,0,500,13350,0,13350,1327500,7880,7880,0,0,0,4450,3338,1864434
300,0,500,13350,0,13350,1327500,7880,7880,0,0,0,4450,3338,1864434
220,0,500,13138,0,13138,13275000,7706,7706,0,0,0,4379,3285,1864434
230,0,500,13138,0,13138,13275000,7694,7694,0,0,0,4379,3285,1864434
234,0,500,13138,0,13138,13275000,7694,7694,0,0,0,4379,3285,1864434
235,0,500,13138,0,13138,13275000,7694,7694,0,0,0,4379,3285,1864434
240,0,9368,32666,0,32666,2275000,19454,19454,0,0,0,8167,10889,1464434
241,0,9368,32666,0,32666,2275000,19454,19454,0,0,0,8167,10889,1464434
242,0,9368,32666,0,32666,2275000,19454,19454,0,0,0,8167,10889,1464434
243,0,9368,32666,0,32666,2275000,19454,19454,0,0,0,8167,10889,1464434
248,0,7494,26132,0,26132,2275000,15642,15642,0,0,0,6533,8711,1464434
249,0,2248,7839,0,7839,2275000,4971,4971,0,0,0,1960,2613,1464434
252,0,9368,32666,0,32666,2275000,19454,19454,0,0,0,8167,10889,1464434
253,0,9368,32666,0,32666,2275000,19454,19454,0,0,0,8167,10889,1464434
254,0,500,13340,0,13340,1327500,7874,7874,0,0,0,3335,4447,1864434
255,0,500,13340,0,13340,1327500,7874,7874,0,0,0,3335,4447,1864434
256,0,500,13340,0,13340,1327500,7874,7874,0,0,0,3335,4447,1864434
250,0,9368,32666,0,32666,2275000,19454,19454,0,0,0,8167,10889,1464434
251,0,9368,32666,0,32666,2275000,19454,19454,0,0,0,8167,10889,1464434
262,0,2500,85000,0,85000,0,610943,610943,0,0,0,170000,440583,420000
,,,,,,,,,,,,,,
